T T M T M " " " . . " " " " " " "
T T M M M " " " . . " " " " " " "
M M M M M T T " " " " " " " " " "
M M M M M T T " " " " " " " " " "
M M M M M T T " " " " " " " " " "
" T T T T " . . ~ . . . . " " " "
" " T " " . . . . . . . " " " " "
" " " " " . . . ~ ~ ~ . " " " " "
" " " " " . . ~ ~ ~ ~ " " " " " "
" " " " " . ~ ~ ~ ~ ~ . . " " " "
" " " " " . ~ ~ ~ ~ ~ . " " " " "
" " " " " " " " " . . . " " " " "
" " " " " " " " " " " " " " " " T
" " " " " " " " " " " " " " " " "
" " " " " " " " " " " " " " " " T
" " " " " " " " " " " " " " " " "
" " " " " " " " " " " " " " " T T
