. . " " " . . . . . . . " . " " "
. . " " " " . . . . " " " " " " "
" " " " " " " . . " " " " " " " "
" " " " " " " . . " " " " " " " "
" " " " " . " . " " " " " " " " "
" " " " " . " . " . " . " " " " "
" " " " " " " " " " " . " " " " "
. " " " " " " " " . . . " " " " "
" " " " " " " " " " " " " " " " "
. . . " " " " " " " " " " " " " "
" " " " " " " " " " " " " " " " "
. . " " " " " " " " " . . . . . .
. . " " " " " " " " " . . . ~ ~ .
. . " " " " " " " . . . ~ ~ ~ ~ ~
. . " " " " " " " " " . ~ ~ ~ ~ ~
. . " " " " " " " " " . ~ ~ ~ ~ ~
. . . . " " " " " " " . . . ~ ~ ~
