" . " " " " " " " " " " " " T T T
. " " " " " " " " " " " " " T T T
" " " " " " T " T " " T T T T T T
" " " " " " " " " " " T T T T T T
" " " " T " T " " " " T T T T T T
" " " " " " T " " " " T T T T T T
" " " " " " T " " " " T T T T T T
" " " " " " " " " " " T T T T T T
" " " " " " " " " " " T T T T T T
" " " " " " " " " " " T T T T T T
" " " " T " " " " " " T T T T T T
" " " " T " T " T " " T T T T T T
" " " " T T T " T " " T T T T T T
" " " " T T T T T T T T T T T T T
" " T T T T T T T T T T T T T T M
" " " " T T T T T T T T T T T T T
" " " " T T T T T T T T T T M T T
