~ ~ ~ ~ ~ ~ ~ ~ ~ ~ ~ . . . . . "
~ ~ ~ ~ ~ ~ ~ ~ ~ ~ ~ . . . . . "
~ ~ ~ ~ ~ ~ ~ ~ ~ ~ ~ . . . " " "
~ ~ ~ ~ ~ ~ ~ ~ ~ ~ ~ . . . . . "
~ ~ ~ ~ ~ ~ ~ ~ ~ ~ ~ . " . " " "
~ ~ ~ ~ ~ . . . . . " " " " " . "
~ ~ ~ ~ ~ . . . . . " " " " " " "
~ ~ ~ ~ ~ . . . " " " . " . " " "
~ ~ ~ ~ ~ ~ . . " " " " " " " " "
~ ~ ~ ~ ~ ~ . . " " " " " " " " "
~ ~ ~ ~ ~ . . . " " " " " " " " "
~ ~ ~ ~ ~ ~ ~ ~ ~ ~ ~ " " . " . .
~ ~ ~ ~ ~ ~ ~ ~ ~ ~ ~ " " " " " "
~ ~ ~ ~ ~ ~ ~ ~ ~ ~ ~ " " " " " "
~ ~ ~ ~ ~ ~ ~ ~ ~ ~ ~ . " " " " "
~ ~ ~ ~ ~ ~ ~ ~ ~ ~ ~ . . . " " "
~ ~ ~ ~ ~ ~ ~ ~ ~ ~ ~ . . . " " "
