~ ~ ~ ~ ~ ~ ~ ~ . . . ~ ~ ~ ~ ~ ~
~ ~ ~ ~ ~ ~ ~ ~ . ~ . ~ ~ ~ ~ ~ ~
~ ~ ~ ~ ~ ~ . . . . . ~ ~ ~ ~ ~ ~
~ ~ ~ ~ ~ ~ . . . . . ~ ~ ~ ~ ~ ~
~ ~ ~ ~ ~ . . . . . " ~ ~ ~ ~ ~ ~
. . . . . . . . " " " " " " " " "
. . . . . . " . " " " " " " " " "
. . . . . . . . " " " " . . " " "
. . . . . . " . " " " " " . " " "
. . . . . . " . " " " " " " " " "
. . . . " " " " " " " " " " " " "
. . . " " " " " " " " " " " " " "
. . " " " " " " " " " " " " " " "
. . " " " " " " " " " " " " " " "
. " " " " " " " " " " " " " " " T
. . " " " " " " " " " " " " " " "
. . " " " " " " " " " " " " " " "
