" " . . . . . . " " " T M M s M M
" " . . . . . . " " " T M M M M M
. " " " " " " " " " T M M M s M M
. . " " " " " " " " " M M M M M M
. . " " " " " " " " " s s M M M M
. . . " " " " " " " " M M M M M M
. . " " " " " " " " T M M M s s s
. . . . . " " " " " " M M M M M M
. . . . " " " " T " " M M M s M M
. . . . " " " " " " " M M M s M M
. . " " " " " " " " " M M M s s M
. . . " " " " " " " " " T T T T T
. . " " " " " " " " " " T T T T T
. . " " " " " " " " " " T T T T T
. . " " " " " " " " " " " " T T T
" " " . " " " " " " " " " T T T T
" " " . " " " " " " " " T T T T T
