T T M M M T T " " . " " " " " " "
T T M M M T T " " " " " " " " " "
T M M M M T T " " " " " " " " " "
T M M M M T T " " " " " " " " " "
M M M M M T T " " " " " T " " " "
T T T T T T M M M M M " " " " " "
" " T " T M M M M M M T T " T " "
" " " " " M M M M M s T " " " " "
" " " " " M M M s s s T T " T " T
. " " " " M M M s M s T T " " T "
" " " " " M s M s s s T T " T " T
. . . . . " T T T T T T T " " " "
. ~ ~ ~ ~ " T " T T T T T " T " T
~ ~ ~ ~ ~ " " " " " T T " " " " T
~ ~ ~ ~ ~ " " " " " " " " " " " T
~ ~ ~ ~ ~ . " " " " " " " " " " "
~ ~ ~ ~ ~ . " " " " " " " " T " "
