" " " . . ~ ~ ~ ~ ~ ~ M M M M M M
" " " . . ~ ~ ~ ~ ~ ~ T M M M M s
. " " " " ~ ~ ~ ~ ~ ~ M M M s s s
. . " " " ~ ~ ~ ~ ~ ~ M M M s M s
. . " " " ~ ~ ~ ~ ~ ~ M M M s M s
~ ~ ~ ~ ~ " " . . " " M M M s s s
~ ~ ~ ~ ~ . " . " " " T M M s s s
~ ~ ~ ~ ~ . . " " " " T M M s s s
~ ~ ~ ~ ~ . . " " " " M M M s s s
~ ~ ~ ~ ~ . . " " " " M M M s s s
~ ~ ~ ~ ~ . " " " " " M M M s s s
~ ~ ~ ~ ~ ~ ~ ~ ~ ~ . . " " T T T
~ ~ ~ ~ ~ ~ ~ ~ ~ ~ ~ . " . " " T
~ ~ ~ ~ ~ ~ ~ ~ ~ ~ ~ . . . " " "
~ ~ ~ ~ ~ ~ ~ ~ ~ ~ ~ ~ ~ . . " "
~ ~ ~ ~ ~ ~ ~ ~ ~ ~ ~ ~ ~ ~ . " "
. ~ ~ ~ ~ ~ ~ ~ ~ ~ ~ ~ ~ ~ ~ . "
