T T M T T " " " " " " M M M M M M
M M M M M T " " " " " T M M M M M
M M M M M T T " " " " M M M s M s
M M M M M T T " " " " M M M M s s
M M M M M T T " " " T M M M s s s
T T T T T T T " " " T T T T T T T
" " T T T T T " " " T T T T T T T
" " " " " " " T " " " " " T T T T
" " " " " " " " T " " " T T T T T
. " " " " " " " " " " " " T T T T
" " " " " " T " " " T " " " T T T
" " " T T " " " " " " T T T T T T
T T T T T " " " " " " T T T T T M
T T T T T " " " " " " T T T T T T
T T T T T T T T " " T T T T M M M
T T T T T " " " " " " T T T T T T
T T T T T T T " " " " T T T T T M
