T T M T M " " " " . " " " " " . .
T T M M M T " " " " " " " " " " "
T T M M M T T " " " " " " " " " "
T T M M M T T " " " " " " " " " "
M T M M M T T " " " " " " " " " "
" " T T T M M M M M M " " " " " "
" " " " T M M M M M M T T " " " "
" " " " " M M M M M M T T " T " "
" " " " " M M M M M M T T " T " "
" " " " " M M M M M M T T " " " "
" " " " " M M M M M M T T " " " "
M M M M M T T T T T T " . . . . "
M M M M M T T T T T T . . . . . .
M M M M M T T T T T T . . . . . .
s s s s s T T T T T T " . . . . .
M M s s s T T T T T T . . . . . ~
M M s s s T T T T " T " . . . ~ ~
