M M M M M M M M M T T . . . ~ . ~
M M M M M M M M M T T . . . ~ ~ ~
M M s M M M s M M M M " " . . ~ ~
M M M M M M s M M M M " . . . . ~
M M M M M M s M M M M " " . . . .
M M M M M M M T T T T T " " " " "
M M s M M M T T T T T T " " " " "
M M M M M T T T T T T " " " " " "
M M M M M T T T T T T T T " T T T
M M M M M T T T T T T T " " " T T
M s s s s T T T T T T T T " T T T
M M s s s s M M M M M T T T T T T
M M s s s s s M M M M T T T T T T
M M M M s s M s M M M T T T T T T
M M s s s s s s s s s M M T T T T
M M s s s s s s s s s M T T T T T
M M s s s s s s s s s M M M T T T
