T T M M M T " " " . " " " " " " "
T T M M M T " " " " " " " " " " "
M M M M M T T " " " " " " " " " "
T M M M M T T " " " " " " " " " "
M M M M s T T " " " " " " " " " "
T T T T T s M M M M M " " " " " "
T T T T T M M M M M M T T T T " "
" " " T " M M M M M M T T " " " "
" " " " T M s M s M M T T T T " "
" " " " " M s M s M M T T T T " "
" " T T T M s s s s s T T T T " "
M M M M M T T T T T T T T T " " "
M M M M s T T T T T T T T " T " T
M M M M M T T T T T T T T " " T T
M M s s s T T T T T T T T T T T T
T M s s s T T T T T T T T T T T T
M M s M s T T T T " T T T T T T T
