T T T T M T " " " " " " " " " . .
T T M T T " " " " " " " " " " . .
M M M M M T T " " " " " " " " " "
M M M M M T T " " " " " " " " " "
M M s M M T T T " " " " " " " " "
T T T T T T T " " " " " " " " " "
" " T T T T T " " " " " " " " " "
" " T T T " " " " " " " " " " " "
" " " " T " " " " " " " " " " " "
. " " " " " " " " " " " " " " " "
" " " " " " " " " " " " " " " " "
" " " " " " " " " " " " " " " " "
" " " " " " " " " " " " " " " " "
" " " " " " " " " " " " " " " " "
" " " " " " " " " " " " " " T T T
. " " " " " " " " " " " " " T " "
. . " " " " " " " " " " " " T " "
