. . . . . ~ ~ ~ ~ ~ ~ M M M M T M
. . . . . ~ ~ ~ ~ ~ ~ T M T M M M
. . " . " ~ ~ ~ ~ ~ ~ T M M M M s
. . . . . ~ ~ ~ ~ ~ ~ T M M M M M
. . " . " ~ ~ ~ ~ ~ ~ T M M M M s
~ ~ ~ ~ ~ . . . . " " T M M M M s
~ ~ ~ ~ ~ . . . " " " M M M s s s
~ ~ ~ ~ ~ . . " " " " M M M s s s
~ ~ ~ ~ ~ . " " " " " M s M s M s
~ ~ ~ ~ ~ . . " " " " M M M s M s
~ ~ ~ ~ ~ . " . " " " M M M s M s
~ ~ ~ ~ ~ ~ ~ ~ ~ ~ ~ . " " T " T
~ ~ ~ ~ ~ ~ ~ ~ ~ ~ ~ ~ . . " " "
~ ~ ~ ~ ~ ~ ~ ~ ~ ~ ~ ~ . . . " "
~ ~ ~ ~ ~ ~ ~ ~ ~ ~ ~ ~ ~ ~ . . "
~ ~ ~ ~ ~ ~ ~ ~ ~ ~ ~ ~ ~ . . . "
~ ~ ~ ~ ~ ~ ~ ~ ~ ~ ~ ~ ~ ~ . . .
