" " " " " " " " " " " T T T T T T
" " " " " " " " " " " T T T T T T
" " " " " " " " " " " T T T T T T
" " " " " " " " " " " T T T T T T
" " " " T " " " " " " T T T T T T
" " " " " " " " " " " T T T T T T
" " T " " " " " " " " T T T T T T
" " " " " " " " " " " T T T T T T
" " " " " " " " T " " T T T T T T
" " " " " " " " " " " T T T T T T
" " T T T T " " " " T T T T T T T
" " " T T T T " " " " T T T T T T
" " T T T T T " T " " T T T T T T
" " " T T T " " " " T T T T T T T
" T T T T T T T T T T T T T M M M
T T T T T T T T T T T T T T M M M
T T T " T T T T T T T T T T M M M
