. ~ ~ ~ ~ ~ ~ ~ ~ ~ ~ ~ ~ ~ . " "
~ ~ ~ ~ ~ ~ ~ ~ ~ ~ ~ ~ ~ . . " "
~ ~ ~ ~ ~ ~ ~ ~ ~ ~ ~ . . . " " "
~ ~ ~ ~ ~ ~ ~ ~ ~ ~ ~ . . . . . .
~ ~ ~ ~ ~ ~ ~ ~ ~ ~ ~ . " . . . .
~ ~ ~ ~ ~ . . . . . . . . . . . .
~ ~ ~ ~ ~ . . . . . " . . . " " "
~ ~ ~ ~ ~ . . " " " " . . . " " "
~ ~ ~ ~ ~ . " " " " " . " " " " "
~ ~ ~ ~ ~ . " " " " " " " " " " "
~ ~ ~ ~ ~ " " " " " " " " " " " "
~ ~ ~ ~ ~ ~ ~ ~ ~ ~ ~ " " " " " "
~ ~ ~ ~ ~ ~ ~ ~ ~ ~ ~ " " " " " "
~ ~ ~ ~ ~ ~ ~ ~ ~ ~ ~ . . " " " "
~ ~ ~ ~ ~ ~ ~ ~ ~ ~ ~ . . " " " "
~ ~ ~ ~ ~ ~ ~ ~ ~ ~ ~ . . " " " "
. ~ ~ ~ ~ ~ ~ ~ ~ ~ ~ . . . " " T
