" " " " " . " . . . " " " . " " "
" " " " " " " " " . " " . . " " "
" " " " " " " " " " " " " " " " "
" " " " " " " " " " " " " " " " "
" " " " " " " " " " " " " " " " "
. . " " " " " " " " " " " " " " "
. . " " " " " " " " " " " " " " "
. . . . . " " " " " " " " " " " "
. . " " " " " " " " " " " " " " "
. . " " " " " " " " " " " " " " "
" " " " " " " " " " " " " " " " "
. . " " " " " " " " " . . . . . .
" . " " " " " " " " " . . ~ . ~ .
. " " " " " " " " " " . . . ~ ~ ~
" " " " " " " " " " " . . ~ . ~ ~
" " " " " " " " " " " . . . ~ . .
" " " " " " " " " " " . . . ~ . .
