M M M M M " " " " . " . . . . " "
M M M M M T " " " " " . . . " " "
M M M M M T T " " " " " " " " " "
T M M M M T T " " " " " " " " " .
T T M M s T T " " " " " " " " " "
" T T T T T T " " " " " " " " " "
" " T T T " T " " " " " " " " " "
. " " " " " " " " " " " " " " " "
. . " " " " " " " " " " " " " " "
. . . . " " " " " " " " . " " " "
. . " " " " " " " " " " " " " " "
. . " " " " " " " " " " " " " " "
" " " " " " " " " " " " " " " " "
" " " " " " " " " " " " " " " " "
" " " " " " " " " " " " " " " " "
" " " " " " " " " " " " " " " T "
" " " " " " " " " " " " " " T T T
