T T M T T " " " " . " " " . " . .
T T M T T " " " " . " " " . . . "
M M M M M " " " " " " " " " " " "
M M M M T " " " " " " " " " " " "
M M M M M T " " " " " " " " " " "
T T T T T " " " " " " " " " " " "
T T T T T " " " " " " " " " " " "
" " T " " " " " " " " " " " " " "
" " " " " " " " " " " " " " " " "
" " " " " " " " " " " " " " " " "
" " " " " " " " " " " " " " " " "
" " " " " " " " " " " " " " " " "
" " " " " " " " " " " " " " " " "
" " " " " " " " " " " " " " " " "
. " " " " " " " " " " " " " " " "
. . " " " " " " " " " " " " " " "
. . " " " " " " " " " " " " " " "
